...................
...................
....g.........g....
...#rg.......gr#...
..g.##.......##.g..
..gW.g.......g..g..
...S...............
...................
...............s...
..g..g.......g.wg..
..g.##.......##.g..
...#rg.......gr#...
....g.........g....
...................
...................
