...................
......S............
....#.g.....g.#....
...W..g.....g......
..#.ggg.....ggg.#..
#.....r.....r.....#
...................
...................
...................
#.....r.....r.....#
..#.ggg.....ggg.#..
......g.....g..w...
....#.g.....g.#....
............s......
...................
