...................
...r...........r...
W...#g..S....g#....
....gg.......gg....
...#gg..#.#..gg#...
...................
...................
...................
...................
...................
...#gg..#.#..gg#...
....gg.......gg....
....#g....s..g#...w
...r...........r...
...................
