...................
...................
...................
.....g.g...g.g.....
...S.g.......g.....
...Wgr###.###rg....
....g.........g....
...................
....g.........g....
....gr###.###rgw...
.....g.......g.s...
.....g.g...g.g.....
...................
...................
...................
