...................
...................
.....S.r...r.......
.#.Wg.g.....g.g..#.
....g.g.....g.g....
..#..#.g...g.#..#..
...................
...................
...................
..#..#.g...g.#..#..
....g.g.....g.g....
.#..g.g.....g.gw.#.
.......r...r.s.....
...................
...................
