...................
...................
...r..W........r...
....g.........g....
.....#.......#.....
...gS..........g...
....g.........g....
...##gg.....gg##...
....g.........g....
...g..........sg...
.....#.......#.....
....g.........g....
...r........w..r...
...................
...................
