...................
..W..S.............
....#.r.....r.#....
...#gg.......gg#...
....#.g.....g.#....
....g.g.....g.g....
...................
...................
...................
....g.g.....g.g....
....#.g.....g.#....
...#gg.......gg#...
....#.r.....r.#....
.............s..w..
...................
