...................
....gg.W.....gg....
...................
...r..gg...gg..r...
...#..#g...g#..#...
...S...#...#.......
...................
...................
...................
.......#...#...s...
...#..#g...g#..#...
...r..gg...gg..r...
...................
....gg.....w.gg....
...................
