...................
........W..........
.......#...#.......
.g.r..S........r.g.
..g.g#.......#g.g..
.....gg.....gg.....
.....#.......#.....
...................
.....#.......#.....
.....gg.....gg.....
..g.g#.......#g.g..
.g.r........s..r.g.
.......#...#.......
..........w........
...................
