...................
.......#...#.......
...g.#g.S...g#.g...
.W.....#...#.......
.....gg.....gg.....
....r.........r....
......g.....g......
...................
......g.....g......
....r.........r....
.....gg.....gg.....
.......#...#.....w.
...g.#g...s.g#.g...
.......#...#.......
...................
