...S...............
...................
........r.r........
...................
.......#...#.......
...gg#.W.....#gg...
...g.gg.....gg.g...
......#.....#......
...g.gg.....gg.g...
...gg#.....w.#gg...
.......#...#.......
...................
........r.r........
...................
...............s...
