...................
...................
...................
.r.Wg.........g..r.
.S##g.........g##..
..#.g.g.....g.g.#..
....g.........g....
...................
....g.........g....
..#.g.g.....g.g.#..
..##g.........g##s.
.r..g.........gw.r.
...................
...................
...................
