...................
.....g.......g.....
.....W.#...#.......
....g.........g....
....grg#...#grg....
....g.........g....
...S..#.....#......
...................
......#.....#..s...
....g.........g....
....grg#...#grg....
....g.........g....
.......#...#.w.....
.....g.......g.....
...................
